10
- - - - - B P B - -
- - G - - - B - - -
- - S - - - - - - -
- S W S - - - B G -
- - S - - - BS P B -
- - - - A S W BS - -
- - - - - - S - - -
- - G G - G G - - -
- - - - G - - - - -
- - - - - - - - - -
